0 2 3 2 3 2 3 2 3 3 3 2 2 2 2 2 3 2 3 3 0 3 3 3 3 3 3 0 
0 2 3 1 1 1 1 1 1 1 1 1 1 2 3 1 1 1 1 2 3 3 3 2 1 1 2 0
0 2 1 1 1 1 2 3 3 2 1 1 1 5 1 1 1 1 1 1 1 4 2 2 1 1 3 0
0 2 1 3 2 1 3 2 3 2 3 2 1 1 5 2 3 2 3 2 3 3 2 5 1 1 3 0
0 2 1 3 1 1 1 3 1 1 1 1 5 1 1 2 1 1 1 1 3 2 2 3 5 1 1 3 
0 2 1 3 1 2 1 3 1 3 2 3 2 3 1 2 3 2 3 1 3 3 2 1 2 2 1 3
0 2 1 1 1 2 1 1 1 3 1 1 1 1 1 1 1 1 1 1 3 4 2 1 1 2 1 2
0 2 1 3 1 2 3 1 3 3 1 2 3 3 1 5 2 3 1 5 3 2 2 1 1 5 1 3
0 2 1 3 1 1 1 2 1 3 1 2 1 3 5 1 2 3 1 1 3 2 3 1 1 2 1 2
2 3 5 3 1 2 1 1 1 2 1 2 1 1 2 3 2 3 5 1 3 4 5 1 1 3 1 3
2 1 1 1 1 2 1 1 1 1 1 2 1 1 1 1 1 1 1 1 3 2 2 1 1 5 1 2
2 3 2 1 1 3 2 3 1 3 2 3 2 3 2 1 2 3 1 1 3 2 1 1 1 2 1 3
3 3 2 1 1 1 2 2 2 3 5 5 5 3 1 5 2 3 1 2 1 3 1 1 1 1 1 2
4 2 2 1 1 5 1 1 2 3 3 2 1 1 2 2 2 2 1 2 3 1 1 2 1 3 2 0
3 2 3 1 1 1 1 1 1 1 2 1 2 3 1 1 5 1 1 1 2 2 4 3 1 3 0 0
3 1 3 3 3 1 1 1 2 1 1 2 1 1 1 1 2 3 1 2 3 3 2 3 1 2 0 0
3 1 5 3 3 3 2 3 3 2 3 2 5 1 3 1 1 1 1 1 1 1 1 1 1 2 0 0
2 3 3 2 0 0 0 0 0 0 0 2 3 3 2 3 2 3 2 3 2 2 2 2 2 3 0 0
